
n -> óre
nn -> númen
nt -> tinco tilde-above
nth -> thúle tilde-above
nc -> calma tilde-above
nch -> harma tilde-above
nchw -> unque tilde-above
ncw -> quesse tilde-above
ng -> 
ngh ->
nghw ->
ngw -> 
nd -> ando tilde-above
ndh -> anto tilde-above
ng -> anga tilde-above
ng (final) -> noldo

t -> tinco
th -> thúle
d -> ando
dh -> anto

m -> vala
mm -> malta
mp -> parma tilde-above
mb -> umbar tilde-above
mf -> formen tilde-above
mf (final) -> ampa tilde-above
mv -> ampa tilde-above

p -> parma
b -> umbar
f (final) -> ampa
f -> formen
v -> ampa

ñ -> noldo
ñc -> calma tilde-above
ñch -> harma tilde-above
ñcw -> quesse tilde-above
ñg -> anga tilde-above
ñgh -> anca tilde-above
ñghw -> unque tilde-above
ñgw -> ungwe tilde-above
ñw -> ñwalme tilde-above

c -> calma
cw -> quesse
ch -> harma
chw -> hwesta
g -> anga
gw -> ungwe
gh -> anca
ghw -> unque
g' -> halla (indicating lenition)

r -> rómen
rh -> arda
l -> lambe
lh -> alda

s -> silme

a -> osse
a' -> osse i-above
ai -> osse y-above
au -> osse w
e -> yanta
ei -> yanta y-above
i -> telco
i' -> telco i-above
i'' -> ára
ii -> telco e-above
ii' -> ára e-above
o -> anna
u -> úre
ui -> úre y-above
w -> wilya
y -> silme-nuquerna
yy -> silme-nuquerna e-tehta

á -> osse e-tehta
é -> yanta e-tehta
í -> short or long carrier e-tehta
ó -> anna e-tehta
ú -> úre e-tehta

h -> hyarmen
hm -> XXX nasalized óre
hw -> hwesta-sindarinwa
hl -> use lh
hr -> use rh

z -> do not use

